NO ./textures/north.xpm
SO ./textures/south.xpm
WE ./textures/west.xpm
EA ./textures/east.xpm

F 40,87,0
C 66,135,245

11111
10001
10N01
10001
11111
