NO ./textures/north.xpm
SO ./textures/south.xpm
WE ./textures/west.xpm
EA ./textures/east.xpm
D ./textures/door.xpm
D1 ./textures/door_1.xpm
D2 ./textures/door_2.xpm
D3 ./textures/door_3.xpm

F 40,87,0
C 66,135,245

        1111111111111111111111111   
        1000000000110000000000001   
        10110000011100000100000011  
        10010000000000000001000001  
1111111110110000011100000000000011  
100000000011000001110111111111111   
11110111111111011100000010001       
11110111111111011101010010001       
11000000110101011100000110001       
10000000000000001100000220201       
10000000000000001101010110001       
11000001110101011111011110N0111     
11110111 1110101 111111010001       
11111111 1111111 11111111111        
