NO ./textures/north.xpm
SO ./textures/south.xpm
WE ./textures/west.xpm
EA ./textures/east.xpm
DT ./textures/upper_door.xpm
DB ./textures/lower_door.xpm

F 40,87,0
C 66,135,245

        1111111111111111111111111
        1000000000110000000000001
        10110000011100000100000011
        10010000000000000001000001
1111111110110000011100000000000011
100000000011000001112111111111111
11110111111111011100000010001
11110111111111011101010010001
11000000110101011100000012111
10000000000000000200000020001
10000000000000001101010010001
1100000111010101111101111000111
11110111 1110101 111111010001
11111111 1111111 11111111111
