NO ./textures/north.xpm
SO ./textures/south.xpm
WE ./textures/west.xpm
EA ./textures/east.xpm
DT ./textures/upper_door.xpm
DB ./textures/lower_door.xpm

F 40,87,0
C 66,135,245

        1111111111111111111111111
        1000000000220000000000001
        10220000022200000200000011
        10020000000000000002000001
1111111110220000022200000000000011
100000000022000001111111111111111
12220222222222022200000020001
12220222222222022202020020001
12000000220202022200000022221
10000000000000000200000020001
10000000000000002202020020001
12000001110202011122022220N01
12220221 1220201 122222020001
11111111 1111111 111111111111
